0000000000000000000000000000000000000000000000000
00000000GZ000000000000000XXXX000000G0G0G0G0G00000
0000000G0YZ00G0000G0000000G00000XXXXXXXXXXXX00000
000000YZYZG00G00000000G000000G0000000G000000G0000
YZ0000000Y000000YZYZYZYZYZYZY00000000000000000000
000000000YYYYY000000000000000000YYYYYYYYYY0000XXX
YZYZ00000Y0000000000000000000G0G0G0G0000000000000
0000G0000Y000000000YYYYYYYYY000000000000000GG0000
0G0YY0G00YYYYYYY0000000000000000YYYYYY00000000000
000000000YG0G000000000000000XX00000000000XXXXXXX0
000000000YYYYYYYYYYG0G0G0G0G0G000000G000000000000
YYYYYYYYYY000000000000000000000000XXXX00000000000
00000000000000000YYYYY000YYYYYY000000000000000000
000000000000000YYYYYYYYYYYYYYYYYYYYYYYYYYYYYYYY00
G0G0YYYYYY00000000000000GGGGGGGGGG00000000000GGG0
0000000000000XXXXXXXXXXXXXXXXXXXXXXXXXXXXXXXXXXXX
0000000000000000000X0000000000000000000000000000X
0000000000YYY0G0G0GX000000G0G0G0G0G0G00000000000X
XXXXXXX000000XXXXXXXXXXXXXXXX0000000000000000000X
000000000000000000000000000000XXXXXXXXXXXX000000X
00000000000000000000f0000000000000000000000000000
00000000GY000000000000000XXXX000000G0G0G0G0G00000
0000000G0YYY0G0000G0000000G00000XXXXXXXXXXXX00000
000000YYYYG00G00000000G000000G0000000G000000G0000
000000000Y000000YYYYYYYYYYYYY00000000000000000000
YYYY00000YYYYY000000000000000000YYYYYYYYYY0000XXX
000000000Y0000000000000000000G0G0G0G0000000000000
0000G0000Y000000000YYYYYYYYY000000000000000GG0000
0G0YY0G00YYYYYYY0000000000000000YYYYYY00000000000
000000000YG0G000000000000000XX00000000000XXXXXXX0
000000000YYYYYYYYYYG0G0G0G0G0G000000G000000000000
YYYYYYYYYY000000000000000000000000XXXX00000000000
00000000000000000YYYYY000YYYYYY000000000000000000
000000000000000YYYYYYYYYYYYYYYYYYYYYYYYYYYYYYYY00
G0G0YYYYYY00000000000000GGGGGGGGGG00000000000GGG0
0000000000000XXXXXXXXXXXXXXXXXXXXXXXXXXXXXXXXXXXX
0000000000000000000X0000000000000000000000000000X
XXXXXXX000YYY0G0G0GX000000G0G0G0G0G0G00000000000X
0000000000000XXXXXXXXXXXXXXXX0000000000000000000X
00000000000000000000000000000000XXXXXXXXXX000000X
0G0G0G0G0G0G0G0G0000000000G0000000000000000000000
0000000000000000XXXXXXXX0000XXXX0G0G0G0XXXXXXXXXX
0YYY00000XXX0000000000000000000000G0G000000000000
0000000G00000G000G00G000G000G00G0000XXXXXXX000000
0000000XX000000XXXX000000000XXXX00000000000000YYY
0YYYY00000000000000000YYYYYY00000000000YYY0GG000G
000000000G000G000G000000G00G000G000000G000000000G
00000000000000YYYYYYYYYYYY000YYYYYYY00000000XXXXX
0GGG000000GGG0YY000W00000000000000YY00000G0G0G0G0
YYYYYYYYYYYYYYYYYYYYYYYYYYYYYYYYYYYYYYYYYYYYYYYYY
