0000000000XYX0000000XX000X00000000000000000000000
00000G0000000000000G00000Y000000000G0BG000G0G0G00
000YXYXY0000000XYX000000G000000000XYXYXYXYXYXYX00
0G00000000XYX0000X0G0X0YXYX00G0G0G000000000000000
XYXY00f000Y000000Y000Y00Y0000XYXY000G00000B000000
000XG00000XY000XYX0G0X00XG00000YXYXYXYXYXYXYXYXYX
000YXY0000GXY00YX000Y00XYXYX0000X000000XY00G00G00
00000000G00Y0000XX0GYX0000000000YX000X00X00000000
000000G0000XG0G0BX000YYXY0000G0G0G0G0YXG0G0G0G0G0
YXYXYXYXYXYYYXYXYX0G0X00000XYXYXYXYXYXYXYXYXYXYXY
XYXYXYXY00000Y00XXXXXX000G00000000000000000000000
YXYXYB0000000X00000000000000000000000000000000000
XYXYXYX0000000000000000000G0000XYXY00000000000G00
YXYXYXYXYXYXYB00000XYXYX0000000000000000000000f00
0000000000000X00X0000000000G000000000000000000000
0000000000000YXYXYXYXY000000000G00000000G000000G0
0B00000000000000000000000G0XYXYXY000000f0000XYXYX
000G000YX000000G000000G0000Y0000000000G0000000000
0G0B0G0Y000000XYX00000XYXYXY00000000G000000000000
XYXYXYXYX0000000000G00Y00000000000G00000000000000
00000000Y0000000000G00X0000000000YXYXYXYXYXYXYXYX
00000000X0000000000G00Y0000000000000000000000G0G0
00000000XYXY00000YXYXY00YY00YY000000000000YXYXYXY
000000000000000000000000000000000000000YXYXYXYXYX
00000000X0000000000G00000000000X0000000YXYXYXYXYX
XYXY000XYX00000G00000000GX00000Y00000000000000000
000X000000000000000000000YX0000X000000000000B0000
000Y0000X0B000000000YXYXYX00000Y00000YXYX00000000
00000000Y0000000000B00000000000X00000X00000000000
XYXYXYXYXYXYXYXYXYXYXYXYXYXYXYXYXYXYXYXYX000000G0
000000000000000000000X000000000000000B000000000XY
000000000G000YX0000W0Y000000000000XYXYXYXY0000000
0000000G00XY00YXYXYXYX00000f000000000000X0000000
0000000XYXY00000X000000000000000000000000Y00000B0
0000G0000000G000Y00000000G000000000000000X000YXYX
000XYX0000G00000X000000YXYXYX00000000000000000000
00000000G00000B0Y00000000000000000000000000000000
000000G000000000X00000000000G0G0G0G0G0G0G0G0G0G00
000000000Y000000Y000f000000000000000000000B000000
YXYXYXYXYX000000X0000000000000XXX000000XYXYX00000
0000000000000000Y000000f00000000000f0000000000000
0000000G000X00000X000000000000000000000000000G0B0
000000000XYY0000YXYXYXYXYXYXYXYXYX0000000000XYXYX
G000G00000X0000000X0000000X00000YY000000000000000
XX0000XXXX00000000X0000G00XX00YYYY000000000000000
0000G0000XXXXX0000X00000G000000YXXXXYY0000f000000
0B000G0000XXXXXXXXX00000G0000000000YY000000000000
0000000000000000000000XXXXXXXXG0G0G00000000000000
YYYYYYYYYYYYYYYYYYYYYYYYYYYYYYYYYYYYYYYYYYYYYYYYY